78
109
4444433344443334444333444433344443334444333444433344443334444333444433344443334444444444433344443334444333444
4444430344443034444303444430344443034444303444430344443034444303444430344443034444444444430344443034444303444
4444430333333033333303333330333333033333303444430344443034444303444430333333033333333333330344443034444303444
3333330000000000000000000000000000000000003333330344443034444303444430000000000000000000000000000000000003444
5555555555555555555555500555555555000000000000000333333033333303333330333333033333333333330333330333333303333
5555555555555555555555500555555555555555555000000000000000000000000000344443034444444444430344430333333300000
3000000000000000000000000000000055555555555555555555555555555555000000344443033334444444430333330000000000555
3000000000000000000000000000000000000000055555555555555555555555555000000000000033333333330000000055555555555
3333333300333333330033333333003333333300000000000000000000000555555555555555555555555555555555555555555555555
3444444300344444430034444443003444444300000000000000000000000000055555555555555555555555555555555555000000000
3444444300344444430034444443003444444300333333330033333333003333000000000000000000000000000000000000000000000
3444444300344444430034444443003444444300344444430034444443003443333300333333330033333333003333333300333333330
3444444300344444430034444443003444444300344444430034444443003444444300344444430034444443003444444300344444430
3333333300333333330033333333003333333300333333330033333333003333333300333333330033333333003333333300333333330
3000000000000000000000000000000000000000000000000000000000000000000000000000000000000000000000000000000000000
3000000000000000000000000000000000000000000000000000000000000000000000000000000000000000000000000000000000000
3333333300333333330033333333003333333300333333330033333333003333333300333333330033333333003333333300333333330
3444444300344444430034444443003444444300344444430034444443003444444300344444430034444443003444444300344444430
3444444300344444430034444443003444444300344444430034444443003444444300344444430034444443003444444300344444430
3444444300344444430034444443003444444300344444430034444443003444444300344444430034444443003444444300344444430
3444444300344444430034444443003444444300344444430034444443003444444300344444430034444443003444444300344444430
3333333300333333330033333333003333333300333333330033333333003333333300333333330033333333003333333300333333330
3000000000000000000000000000000000000000000000000000000000000000000000000000000000000000000000000000000000000
3000000000000000000000000000000000000000000000000000000000000000000000000000000000000000000000000000000000000
3333333300333333330033333333003333333300333333330033333333003333333300333333330033333333003333333300333333330
3444444300344444430034444443003444444300344444430034444443003444444300344444430034444443003444444300344444430
3444444300344444430034444443003444444300344444430034444443003444444300344444430034444443003444444300344444430
3444444300344444430034444443003444444300344444430034444443003444444300344444430034444443003444444300344444430
3444444300344444430034444443003444444300344444430034444443003444444300344444430034444443003444444300344444430
3333333300333333330033333333003333333300333333330033333333003333333300333333330033333333003333333300333333330
3000000000000000000000000000000000000000000000000000000000000000000000000000000000000000000000000000000000000
3000000000000000000000000000000000000000000000000000000000000000000000000000000000000000000000000000000000000
3333333300333333330033333333003333333300333333330033333333003333333300333333330033333333003333333300333333330
3444444300344444430034444443003444444300344444430034444443003444444300344444430034444443003444444300344444430
3444444300344444430034444443003444444300344444430034444443003444444300344444430034444443003444444300344444430
3444444300344444430034444443003444444300344444430034444443003444444300344444430034444443003444444300344444430
3444444300344444430034444443003444444300344444430034444443003444444300344444430034444443003444444300344444430
3333333300333333330033333333003333333300333333330033333333003333333300333333330033333333003333333300333333330
3000000000000000000000000000000000000000000000000000000000000000000000000000000000000000000000000000000000000
3000000000000000000000000000000000000000000000000000000000000000000000000000000000000000000000000000000000000
3333333300333333330033333333003333333300333333330033333333003333333300333333330033333333003333333300333333330
3444444300344444430034444443003444444300344444430034444443003444444300344444430034444443003444444300344444430
3444444300344444430034444443003444444300344444430034444443003444444300344444430034444443003444444300344444430
3444444300344444430034444443003444444300344444430034444443003444444300344444430034444443003444444300344444430
3444444300344444430034444443003444444300344444430034444443003444444300344444430034444443003444444300344444430
3333333300333333330033333333003333333300333333330033333333003333333300333333330033333333003333333300333333330
3000000000000000000000000000000000000000000000000000000000000000000000000000000000000000000000000000000000000
3000000000000000000000000000000000000000000000000000000000000000000000000000000000000000000000000000000000000
3333333300333333330033333333003333333300333333330033333333003333333300333333330033333333003333333300333333330
3444444300344444430034444443003444444300344444430034444443003444444300344444430034444443003444444300344444430
3444444300344444430034444443003444444300344444430034444443003444444300344444430034444443003444444300344444430
3444444300344444430034444443003444444300344444430034444443003444444300344444430034444443003444444300344444430
3444444300344444430034444443003444444300344444430034444443003444444300344444430034444443003444444300344444430
3333333300333333330033333333003333333300333333330033333333003333333300333333330033333333003333333300333333330
3000000000000000000000000000000000000000000000000000000000000000000000000000000000000000000000000000000000000
3000000000000000000000000000000000000000000000000000000000000000000000000000000000000000000000000000000000000
3333333300333333330033333333003333333300333333330033333333003333333300333333330033333333003333333300333333330
3444444300344444430034444443003444444300344444430034444443003444444300344444430034444443003444444300344444430
3444444300344444430034444443003444444300344444430034444443003444444300344444430034444443003444444300344444430
3444444300344444430034444443003444444300344444430034444443003444444300344444430034444443003444444300344444430
3444444300344444430034444443003444444300344444430034444443003444444300344444430034444443003444444300344444430
3333333300333333330033333333003333333300333333330033333333003333333300333333330033333333003333333300333333330
3000000000000000000000000000000000000000000000000000000000000000000000000000000000000000000000000000000000000
3000000000000000000000000000000000000000000000000000000000000000000000000000000000000000000000000000000000000
3333333300333333330033333333003333333300333333330033333333003333333300333333330033333333003333333300333333330
3444444300344444430034444443003444444300344444430034444443003444444300344444430034444443003444444300344444430
3444444300344444430034444443003444444300344444430034444443003444444300344444430034444443003444444300344444430
3444444300344444430034444443003444444300344444430034444443003444444300344444430034444443003444444300344444430
3444444300344444430034444443003444444300344444430034444443003444444300344444430034444443003444444300344444430
3333333300333333330033333333003333333300333333330033333333003333333300333333330033333333003333333300333333330
3000000000000000000000000000000000000000000000000000000000000000000000000000000000000000000000000000000000000
3000000000000000000000000000000000000000000000000000000000000000000000000000000000000000000000000000000000000
3333333300333333330033333333003333333300333333330033333333003333333300333333330033333333003333333300333333330
3444444300344444430034444443003444444300344444430034444443003444444300344444430034444443003444444300344444430
3444444300344444430034444443003444444300344444430034444443003444444300344444430034444443003444444300344444430
3444444300344444430034444443003444444300344444430034444443003444444300344444430034444443003444444300344444430
3444444300344444430034444443003444444300344444430034444443003444444300344444430034444443003444444300344444430
3333333333333333333333333333333333333333333333333333333333333333333300333333330033333333333333333300333333330